#...@..#..#
###..###..#
..#..#....#
#......#..#
###..###..#
..#..#....#